انتخابات - 选举
ميدان - 广场
الشرطة - 警察
ثورة - 革命
تحالف - 联盟
تظاهر - 示威
المعاشات - 养老金
الدستور - 宪法
المحاكم - 法院
العمال - 工人
الشباب - 青年
العدالة - 正义
الحرية والعدالة - 自由与正义
سلطة - 权力
المعارضة - 反对派
ديمقراطية - 民主
فساد - 腐败
الجامعات - 大学
حرية - 自由
الرئيس - 总统
الفساد - 腐败
التضخم - 通胀
احتجاج - 抗议
الأمن - 安全
تغيير - 改革
فقر - 贫穷
إضراب - 罢工
عنف - 暴力
المستشفيات - 医院
الخبز - 面包
الفقر - 贫穷
تضخم - 通货膨胀
السياسة - 政治
الشهداء - 烈士
الوحدة الوطنية - 民族团结
انقلاب - 政变
مظاهرة - 示威
الاستقلال - 独立
مقاومة - 抵抗
الحقوق - 权利
شغب - 骚乱
بطالة - 失业
التضامن - 团结
الأسعار - 价格
شباب الثورة - 革命青年
اضطراب - 动荡
سباق - 种族的
انتفاضة - 起义
العدالة الاجتماعية - 社会公正
حالة الطوارئ - 紧急状态