ثورة - 革命
انتخابات - 选举
سلطة - 权力
تغيير - 改革
حرية - 自由
فساد - 腐败
عنف - 暴力
تظاهر - 示威
الفساد - 腐败
احتجاج - 抗议
فقر - 贫困
المعارضة - 反对派
شغب - 骚乱
قمع - 镇压
بطالة - 失业
الطلاب - 学生
البطالة - 失业
سباق - 种族的
العدالة الاجتماعية - 社会公正
اضطراب - 动荡
الشفافية - 透明度
التضامن - 团结
الحرية والعدالة - 自由与正义
مقاومة - 抵抗
الأمان - 安全
مظاهرة - 示威
شباب الثورة - 革命青年
تضخم - 通货膨胀
حقوق الإنسان - 人权
الاستقلال - 独立
الشهداء - 烈士
الأسواق - 市场
الوحدة الوطنية - 民族团结
إضراب - 罢工
انتفاضة - 起义
انقلاب - 政变
المجلس العسكري - 军事委员会
التضخم - 通胀
ديكتاتورية - 独裁
مطالب الشعب - 人民的诉求
نظام الحكم - 政权
الانتفاضة - 起义
الرواتب - 工资
الديكتاتورية - 独裁
النضال - 斗争
حالة الطوارئ - 紧急状态
رئاسة الجمهورية - 总统职位
الأحزاب السياسية - 政党
عدالة اجتماعية - 社会公正
ثورة الشباب - 青年革命
الشرفاء - 正义人士
متحرر - 自由的
الإخوان المسلمون - 穆斯林兄弟会
الخدمات العامة - 公共服务
العيش الكريم - 体面生活
قانون الطوارئ - 紧急法案
شهداء الثورة - 革命烈士
حقوق المواطنين - 公民权利
مظاهرات سلمية - 和平示威
حقوق المرأة - 女性权利
انتهاكات حقوق الإنسان - 人权侵犯
ثورة سلمية - 和平革命
إعلام حر - 自由媒体
إصلاحات سياسية - 政治改革
الوضع الاقتصادي - 经济形势
الشعب يريد إسقاط النظام - 人民要推翻政权
عنف الشرطة - 警察暴力
أزمة اقتصادية - 经济危机
التغيير السلمي - 和平变革
الحزب الوطني الديمقراطي - 民主国家党
الأحوال المعيشية - 生活条件
انتفاضة شعبية - 民众起义
وحشية الشرطة - 警察暴力
أسعار الغذاء - 食品价格
قضاء مستقل - 独立司法
قوة الجيش - 军队力量
أحكام قضائية - 司法判决