ثورة - 革命  
احتجاج - 抗议  
مظاهرة - 示威  
انقلاب - 政变  
شباب الثورة - 革命青年  
انتفاضة شعبية - 民众起义
شهداء الثورة - 革命烈士  
نظام الحكم - 政权  
ديكتاتورية - 独裁  
مبارك - 穆巴拉克  
عنف الشرطة - 警察暴力  
قمع - 镇压
حقوق المواطنين - 公民权利  
إصلاح الدستور - 宪法改革  
فساد الحكومة - 政府腐败  
عدالة اجتماعية - 社会公正  
فقر - 贫困  
بطالة - 失业  
تضخم - 通货膨胀  
أزمة اقتصادية - 经济危机  
حالة الطوارئ - 紧急状态  
مطالب الشعب - 人民的诉求  
إضراب - 罢工  
قضاء مستقل - 独立司法  
إعلام حر - 自由媒体  
انتهاكات حقوق الإنسان - 人权侵犯  
إضراب العمال - 工人罢工  
إصلاحات سياسية - 政治改革  
ثورة الشباب - 青年革命  
حركة 6 أبريل - 四月六日运动  
قوة الجيش - 军队力量  
رئاسة الجمهورية - 总统职位  
المعارضة - 反对派  
الشعب يريد إسقاط النظام - 人民要推翻政权 
التغيير السلمي - 和平变革  
الحزب الوطني الديمقراطي - 民主国家党  
أحكام قضائية - 司法判决  
مظاهرات سلمية - 和平示威  
العيش الكريم - 体面生活  
الحرية والعدالة - 自由与正义  
حقوق المرأة - 女性权利  
الشهداء - 烈士  
العدالة الاجتماعية - 社会公正  
البطالة - 失业  
التضخم - 通胀  
الفساد - 腐败  
المجلس العسكري - 军事委员会  
شغب - 骚乱  
احتجاج - 抗议  
ثورة سلمية - 和平革命  
فيسبوك ثورة - 脸书革命  
ثورة الشباب - 青年革命  
الإخوان المسلمون - 穆斯林兄弟会  
الديكتاتورية - 独裁  
قانون الطوارئ - 紧急法案  
وحشية الشرطة - 警察暴力