ثورة - 革命  
احتجاج - 抗议  
مظاهرة - 示威  
انقلاب - 政变  
شباب الثورة - 革命青年  
انتفاضة شعبية - 民众起义  
ميدان - 广场  
شهداء الثورة - 革命烈士  
نظام الحكم - 政权  
ديكتاتورية - 独裁  
مبارك - 穆巴拉克  
عنف الشرطة - 警察暴力  
قمع - 镇压  
حرية - 自由  
حقوق المواطنين - 公民权利  
إصلاح الدستور - 宪法改革  
انتخابات - 选举  
فساد الحكومة - 政府腐败  
سلطة - 权力  
ديمقراطية - 民主  
عدالة اجتماعية - 社会公正  
فقر - 贫困  
بطالة - 失业  
تضخم - 通货膨胀  
أسعار الغذاء - 食品价格  
أزمة اقتصادية - 经济危机  
حالة الطوارئ - 紧急状态  
مطالب الشعب - 人民的诉求  
الشرطة - 警察  
الرئيس - 总统  
إضراب - 罢工  
قضاء مستقل - 独立司法  
تغيير - 改革  
إعلام حر - 自由媒体  
انتهاكات حقوق الإنسان - 人权侵犯  
الوحدة الوطنية - 民族团结  
الأحزاب السياسية - 政党  
إضراب العمال - 工人罢工  
مقاومة - 抵抗  
إصلاحات سياسية - 政治改革  
ثورة الشباب - 青年革命  
تظاهر - 示威  
حركة 6 أبريل - 四月六日运动  
قوة الجيش - 军队力量  
رئاسة الجمهورية - 总统职位  
المعارضة - 反对派  
تحالف - 联盟  
الشعب يريد إسقاط النظام - 人民要推翻政权  
الشباب - 青年  
العدالة - 正义  
النضال - 斗争  
الحقوق - 权利  
الأمان - 安全  
التغيير السلمي - 和平变革  
الحزب الوطني الديمقراطي - 民主国家党  
أحكام قضائية - 司法判决  
مظاهرات سلمية - 和平示威  
حقوق الإنسان - 人权  
العيش الكريم - 体面生活  
الحرية والعدالة - 自由与正义  
حقوق المرأة - 女性权利  
الانتفاضة - 起义  
الشرفاء - 正义人士  
الشهداء - 烈士  
الاستقلال - 独立  
الإصلاح الاجتماعي - 社会改革  
الدستور - 宪法  
الوضع الاقتصادي - 经济形势  
الفقر - 贫穷  
التضامن - 团结  
العدالة الاجتماعية - 社会公正  
البطالة - 失业  
التضخم - 通胀  
المعاشات - 养老金  
الرواتب - 工资  
الأسعار - 价格  
الخبز - 面包  
الفساد - 腐败  
الشفافية - 透明度  
المحاكم - 法院  
المحامون - 律师  
العمال - 工人  
الطلاب - 学生  
الأساتذة - 教授  
الجامعات - 大学  
التعليم - 教育  
المستشفيات - 医院  
الخدمات العامة - 公共服务  
الأسواق - 市场  
الحكومة - 政府  
المجلس العسكري - 军事委员会  
الأمن - 安全  
الأحوال المعيشية - 生活条件  
حقوق الإنسان - 人权  
السياسة - 政治  
الاقتصاد - 经济  
شغب - 骚乱  
انتفاضة - 起义  
احتجاج - 抗议  
اضطراب - 动荡  
ثورة - 革命  
ثورة سلمية - 和平革命  
فيسبوك ثورة - 脸书革命  
ثورة الشباب - 青年革命  
الإخوان المسلمون - 穆斯林兄弟会  
شباب - 青年  
عنف - 暴力  
أجنبي - 外来的  
سباق - 种族的  
متحرر - 自由的  
فساد - 腐败  
فقر - 贫穷  
بطالة - 失业  
الديكتاتورية - 独裁  
قانون الطوارئ - 紧急法案  
وحشية الشرطة - 警察暴力